■■■■■■■■■■■■■■■■■■■■■■■■■■■■■■■■■■■■■■■■■■■■■■■■
■····■·■·········■··········■···········■······■
■·■■■■·■■■■·■■■■■■■■■■·■■■■■■■■■■·■■■■■■■·■■·■■■
■·····················●························■
■·■■■■·■■■■■■■■■■■■■■■■■■■■■■■■■■■■■■■■■■·■■■■·■
■·········●····■░░░░░░░░░░░░■·····●············■
■■■■■■·■■■■■■■·░░░░░░░░░░░░░░·■■■■■■■■■■■·■■■■■■
■····■·■··●····■░░░░░░░░░░░░■·····●·····■·■····■
■■■■···■■■■■■■■■■■■■■■■■■■■■■■■■■■■■■■■■■···■■■■
■····■················●···················■····■
■·■■■■·■■■■■■■■■■■■■■■■■■■■■■■■■■■■■■■■■■·■■■■■■
■····■·■································■·■····■
■·■■■■·■■■■·■■■■■■■■■■·■■■■■■■■■■·■■■■■■■·■■·■■■
■················■··········■··················■
■■■■■■■■■■■■■■■■■■■■■■■■■■■■■■■■■■■■■■■■■■■■■■■■
