■■■■■■■■■■■■■■■■■■■■■■■■■■■■■■■■■■■■■■■■■■■■■■■■
■    ■ ■         ■          ■           ■      ■
■ ■■■■ ■■■■ ■■■■■■■■■■ ■■■■■■■■■■ ■■■■■■■ ■■ ■■■
■                                              ■
■ ■■■■ ■■■■■■■■■■■■■■■■■■■■■■■■■■■■■■■■■■ ■■■■ ■
■              ■░░░░░░░░░░░░■                  ■
■■■■■■ ■■■■■■■ ░░░░░░░░░░░░░░ ■■■■■■■■■■■ ■■■■■■
■    ■ ■       ■░░░░░░░░░░░░■           ■ ■    ■
■■■■   ■■■■■■■■■■■■■■■■■■■■■■■■■■■■■■■■■■   ■■■■
■    ■                                    ■    ■
■ ■■■■ ■■■■■■■■■■■■■■■■■■■■■■■■■■■■■■■■■■ ■■■■■■
■    ■ ■                                ■ ■    ■
■ ■■■■ ■■■■ ■■■■■■■■■■ ■■■■■■■■■■ ■■■■■■■ ■■ ■■■
■             ···■          ■                  ■
■■■■■■■■■■■■■■■■■■■■■■■■■■■■■■■■■■■■■■■■■■■■■■■■
