■■■■■■■■■■■■■■■■■■■■■■■■■■■■■■■■■■■■■■■■■■■■■■■■■■■■■■■■■■■■■■■■■■■■■■■■■■■■■■■■
■●············································································●■
■■■■■■■■■■■■·■■■■■■■■■■■■■■■■■■■■■■■■■·■■■■■■■■■■■■■■■■■■■■■■■■■■■■·■■■■■■■■■■■■
■●■·······●■·········■····································■·········■●·······■●■
■·■·■■■■■■■■·■■■■■■■■■·■■■■■■■■■■■■■■■■■■■■■■■■■■■■■■■■■■·■■■■■■■■■·■■■■■■■■·■·■
■·■··················■·■·········■··········■···········■·■··················■·■
■·■■■·■■■■■■■■■■·■■■■■·■■■■·■■■■■■■■■■·■■■■■■■■■■·■■■■■■■·■■·■■■■■■■■■■·■■■■■■·■
■·■··················■·■··············●·················■·■··················■·■
■·■■■■■■■■■■■■■■■■■■■■·■■■■■■■■■■■■■■■■■■■■■■■■■■■■■■■■■■·■■■■■■■■■■■■■■■■■■■■·■
■·························●····■            ■·····●····························■
■·■■■■■■■■■■■■■■■■■■■■·■■■■■■■·              ·■■■■■■■■■■■·■■■■■■■■■■■■■■■■■■■■·■
■····················■·■··●····■            ■·····●·····■·■····················■
■■■■■■■■■■■■■■■■■■■■·■·■■■■■■■■■■■■■■■■■■■■■■■■■■■■■■■■■■·■·■■■■■■■■■■■■■■■■■■■■
■········●···········■················●···················■···········●········■
■·■■■■·■■■■·■■■■·■■■■■·■■■■■■■■■■■■■■■■■■■■■■■■■■■■■■■■■■·■■■■■·■■■■·■■■■·■■■■·■
■·■··················■·■································■·■··················■·■
■·■■■·■■■■■■■■■■·■■■■■·■■■■·■■■■■■■■■■·■■■■■■■■■■·■■■■■■■·■■·■■■■■■■■■■·■■■■■■·■
■·■······························■··········■································■·■
■·■·■■■■■■■■·■■■■■■■■■■■■■■■■■■■■■■■■■■■■■■■■■■■■■■■■■■■■■■■■■■■■■■·■■■■■■■■·■·■
■●■·······●■··························●·····························■●·······■●■
■■■■■■■■■■■■·■■■■■■■■■■■■■■■■■■■■■■■■■■■■■■■■■■■■■■■■■■■■■■■■■■■■■■·■■■■■■■■■■■■
■●····································●·······································●■
■■■■■■■■■■■■■■■■■■■■■■■■■■■■■■■■■■■■■■■■■■■■■■■■■■■■■■■■■■■■■■■■■■■■■■■■■■■■■■■■