■■■■■■■■■■■■■■■■■■■■■■■■■■■■■■■■■■■■■■■■■■■■■■■■■■■■■■■■■■■■■■■■■■■■■■■■■■■■■■■■
■●············································································●■
■■■■■■■■■■■■·■■■■■■■■■■■■■■■■■■■■■■■■■·■■■■■■■■■■■■■■■■■■■■■■■■■■■■·■■■■■■■■■■■■
■●■·······●■·········■····································■·········■●·······■●■
■·■·■■■■■■■■·■■■■■■■■■·■■■■■■■■■■■■■■■·■■■■■■■■■■■■■■■■■■·■■■■■■■■■·■■■■■■■■·■·■
■·■··················■·■·········■··········■···········■·■··················■·■
■·■■■·■■■■■■■■■■·■■■■■·■■■■·■■■■■■■■■■·■■■■■■■■■■·■■■■■■■·■■·■■■■■■■■■■·■■■■■■·■
■·■··················■·■··············●·················■·■··················■·■
■·■■■■■■■■■■■■■■■■■■■■·■■■■■■■■■■■■■■■■■■■■■■■■■■■■■■■■■■·■■■■■■■■■■■■■■■■■■■■·■
■·························●····■░░░░░░░░░░░░■·····●····························■
■·■■■■■■■■■■■■■■■■■■■■·■■■■■■■·░░░░░░░░░░░░░░·■■■■■■■■■■■·■■■■■■■■■■■■■■■■■■■■·■
■····················■·■··●····■░░░░░░░░░░░░■·····●·····■·■····················■
■■■■■■■■■■■■■■■■■■■■·■·■■■■■■■■■■■■■■■■■■■■■■■■■■■■■■■■■■·■·■■■■■■■■■■■■■■■■■■■■
■········●···········■················●···················■···········●········■
■·■■■■·■■■■·■■■■·■■■■■·■■■■■■■■■■■■■■■■■■■■■■■■■■■■■■■■■■·■■■■■·■■■■·■■■■·■■■■·■
■·■··················■·■································■·■··················■·■
■·■■■·■■■■■■■■■■·■■■■■·■■■■·■■■■■■■■■■·■■■■■■■■■■·■■■■■■■·■■·■■■■■■■■■■·■■■■■■·■
■·■······························■··········■································■·■
■·■·■■■■■■■■·■■■■■■■■■■■■■■■■■■■■■■■■■■■■■■■■■■■■■■■■■■■■■■■■■■■■■■·■■■■■■■■·■·■
■●■·······●■··························●·····························■●·······■●■
■■■■■■■■■■■■·■■■■■■■■■■■■■■■■■■■■■■■■■■■■■■■■■■■■■■■■■■■■■■■■■■■■■■·■■■■■■■■■■■■
■●····································●·······································●■
■■■■■■■■■■■■■■■■■■■■■■■■■■■■■■■■■■■■■■■■■■■■■■■■■■■■■■■■■■■■■■■■■■■■■■■■■■■■■■■■
